11111111111111111111111111
1P001C000000000000000000C1
11101111111010111111101111
1000001000101010000C100001
10111110101010101110111101
10100000101010101000100001
10101111101010101011101111
10001C00001010100000100001
1C0010000000000011111000E1
11111111111111111111111111